0 0 0 0 0 2 0 0 0 0 0 0 0 0 0 0 0 0 0 2 0 0 0 0 0
0 0 0 0 0 2 0 0 0 0 0 0 0 0 0 0 0 0 0 2 0 0 0 0 0
0 0 0 0 0 2 0 0 0 0 0 0 0 0 0 0 0 0 0 2 0 0 0 0 0
0 0 0 0 0 2 6 6 0 0 0 0 0 0 0 0 0 6 6 2 0 0 0 0 0
0 0 0 0 0 2 6 6 6 6 6 6 6 6 6 6 6 6 6 2 0 0 0 0 0
0 0 0 0 0 2 0 0 0 0 0 0 0 0 0 0 0 0 0 2 0 0 0 0 0
0 0 0 0 0 2 2 2 2 2 1 0 0 0 1 2 2 2 2 2 0 0 0 0 0
0 0 0 0 0 0 0 0 0 0 0 0 0 0 0 0 0 0 0 0 0 0 0 0 0
0 0 0 0 0 0 0 0 0 0 0 0 0 0 0 0 0 0 0 0 0 0 0 0 0
0 0 0 0 0 0 0 0 0 0 0 0 0 0 0 0 0 0 0 0 0 0 0 0 0
0 0 0 0 0 0 0 0 0 0 0 0 0 0 0 0 0 0 0 0 0 2 2 2 2
0 0 0 0 0 0 0 0 0 0 0 0 0 0 0 2 2 2 2 0 0 0 0 0 0
0 0 0 0 0 0 0 0 0 0 0 0 0 0 0 0 0 0 0 0 0 0 0 0 0
0 0 0 0 0 0 0 0 0 0 0 0 0 0 0 0 0 0 0 2 2 2 2 0 0
0 0 0 0 0 0 0 0 0 0 0 0 0 0 0 0 0 0 0 0 0 0 0 0 0
0 0 0 0 0 0 0 0 0 0 0 0 0 0 0 0 0 0 0 0 0 0 0 0 0
1 1 1 1 1 1 1 1 1 1 0 0 0 0 0 1 1 1 1 1 1 1 1 1 1
5 5 5 5 5 5 5 5 5 5 4 4 4 4 4 5 5 5 5 5 5 5 5 5 5
5 5 5 5 5 5 5 5 5 5 4 4 4 4 4 5 5 5 5 5 5 5 5 5 5
5 5 5 5 5 5 5 5 5 5 4 4 4 4 4 5 5 5 5 5 5 5 5 5 5
5 5 5 5 5 5 5 5 5 5 4 4 4 4 4 5 5 5 5 5 5 5 5 5 5
5 5 5 5 5 5 5 5 5 5 4 4 4 4 4 5 5 5 5 5 5 5 5 5 5
1 1 1 1 1 1 1 1 1 1 0 0 0 0 0 1 1 1 1 1 1 1 1 1 1           
3 3 3 3 3 3 3 1 1 1 0 0 0 0 0 1 1 1 3 3 3 3 3 3 3
2 2 2 3 3 3 3 1 1 1 0 0 0 0 0 1 1 1 3 3 3 3 2 2 2
2 0 0 0 0 2 0 1 1 1 0 0 0 0 0 1 1 1 0 2 0 0 0 0 2
2 0 0 0 0 2 0 1 1 1 0 0 0 0 0 1 1 1 0 2 0 0 0 0 2
2 2 1 1 0 0 0 1 1 2 2 2 2 2 2 2 1 1 0 0 0 1 1 2 2
0 0 1 1 0 0 0 0 0 0 0 0 0 0 0 0 0 0 0 0 0 1 1 0 0
3 3 3 3 0 0 0 0 0 0 0 0 0 0 0 0 0 0 0 0 0 3 3 3 3
0 0 0 0 0 0 0 0 0 0 0 0 0 0 0 0 0 0 0 0 0 0 0 0 0
3 3 1 1 0 1 1 1 2 1 1 1 1 1 1 1 2 1 1 1 0 1 1 3 3
3 3 1 1 2 2 1 1 0 1 1 1 1 1 1 1 0 1 1 2 2 1 1 3 3
3 3 1 1 2 2 1 1 3 2 0 1 1 1 0 2 3 1 1 2 2 1 1 3 3
3 3 1 1 0 1 1 1 3 2 2 0 0 0 2 2 3 1 1 1 0 1 1 3 3
3 3 0 0 0 0 0 0 0 0 0 0 2 0 0 0 0 0 0 0 0 0 0 3 3
3 3 0 0 0 0 0 2 1 0 0 0 0 0 0 0 1 2 0 0 0 0 0 3 3
3 3 3 3 3 0 0 2 1 0 0 0 0 0 0 0 1 2 0 0 3 3 3 3 3